#################################################
#                                               #
#                                     #         #
#                                               #
#          #                          #         #
#          #                                    #
#          #                          #         #
#          #      #     #                       #
A          #      #     #             #         #
#                  #   #                        #
B                   ###                         #
#                                               #
#                                               #
C                        ####  ####  ####       #
#                                               #
#                                               #
#                                               #
#                                               #
#                                               #
#################################################