#################################################
#                                               #
#                                               #
#                    #####                      #
#                   #     #                     #
#                  #       #                    #
#                  #       #                    #
#                                               #
#                                               #
#                                               #
#                                 #             #
#                                 #             #
#                                 #             #
#                                               #
#            #####                              #
#                                               #
#                                               #
#                                               #
#                                               #
#################################################