#################################
#                               #
#                               #
#                               #
#                               #
#            ###                #
#            ###                #
#                               #
#                               #
#        ###############        #
#                               #
#                               #
#                               #
#        ###############        #
#                               #
#                               #
#            ###                #
#            ###                #
#                               #
#                               #
#                               #
#                               #
#################################